1111111111111111111111111111
1E1010000P00000000C000000001
10101111111111111111111111C1
1C10000000000000000000000101
1011111111111111111111111101
100C00000C00000C00000A00C001
1111111111111111111111111111