1111111111111111111111111111111111111111111111
1E0000000000000000C000000000001000000000000001
1000000011111111111111111110001111111000000001
1111111110000000000000000000000000001001111111
10000C0000000000000000000000001000000001000001
1000111111111111111111111001111000001001000001
1000000C00000000000000001001000000001001000001
1111111111111111111111001001111111111001111111
1000000000000000000001001000000000000000000001
1001110111111111111111001001111111110011111111
100100P00000000000000C001001000000010010000001
1001001111111111111111111111000000000010000001
1001000000000000000000000000000000010010000001
1111111111111111111111111111111111111111111111