1111111111111
1P00C0CC000E1
1000000000001
1111111111111