1111111111111
1P00C0CC000E1
10000A0000001
1111111111111