1111111111111
1P00C0CCC00E1
1000000000001
1111111111111