11111111111111111
100000001000C0001
10P000000000000E1
100000001000C0001
11111111111111111