1111111111111111111111
1C001C00000C000000C1C1
1000100000000011111101
111C1000000C0000000001
1110000011111111110101
1C1C1000000000001001C1
1C001111111000101011C1
1000000C000P0010100001
10011000001110001C0001
1001001111100011111001
100000100E100C00001001
1011001000111111001001
10C1000000000000001001
10C10000C000C000C01CC1
1111111111111111111111