11111111111111111111111
10000000000000000000001
10010011000000110011001
10110000100000001000101
10010011100000111000101
10010000100000001000101
10111011000000110000101
100000000000P0000000001
10000000000000000000001
10000000000000000000001
10000000000000000000001
10000CC00000000000C0001
100000000E0000000000001
10000000000000000000001
10000000000000000000001
11111111111111111111111
